++++++++++++++++++++++++++++++++
+..............................+
+........[~~~~]................+
+........[~~~~]................+
+........[~~~~].......++++++++++
+.....................[~~~~~~~~+
+....+++=+++..........[~~~~~~~~+
+....+~~~~~+..........[~~~~~~~~+
+....+~~~~~+..........[~~~~~~~~+
++++++......+=========[~~~~~~~~+
+...........+=======++++++++++++
+........+++++..............++++
+..............................+
+..........=+++++++++====+++++++
+.........+....................+
+........+.....................+
+.....+++...+++++++++..........+
+~~.~++.....+~~~~~~~+..........+
+....+......+~~~~~~~+..........+
+....+......+~~~~~~~+..........+
+....+......+~~~~~~~+..........+
+....+......+++++++++..........+
+.$$.+.........................+
++++++++++++++++T+++++++++++++++
