++++++++++++++++++++++++++++++++
+..............................+
+..............................+
+..............................+
+..............................+
+..............................+
+..............................+
+..............................+
+.......D......................+
+..............................+
+..............................+
+..............................+
+..............................+
+..............................+
+..............................+
+......................-----...+
+...-.-.---.....-..-...-.......+
+...-.-.-.-....-.--.-..-----...+
+...---.-.-...-..-..-..-.......+
+...-.-.---..-...-...-.-----...+
+..............................+
+..............................+
+..............................+
++++++++++++++++++++++++++++++++
